Уровень №3. 444
26,80
1:03 0:00 0:00 0:00 0:00 0:00 1:01 0:00 0:00 0:00 0:00 0:00 1:04 0:00 0:00 0:00
1:03 0:00 0:00 1:03 0:00 0:00 1:01 0:00 0:00 1:01 0:00 0:00 1:04 0:00 0:00 1:04
1:03 0:00 0:00 1:03 0:00 0:00 1:01 0:00 0:00 1:01 0:00 0:00 1:04 0:00 0:00 1:04
1:03 0:00 0:00 1:03 0:00 0:00 1:01 0:00 0:00 1:01 0:00 0:00 1:04 0:00 0:00 1:04
1:03 1:03 1:03 1:03 0:00 0:00 1:01 1:01 1:01 1:01 0:00 0:00 1:04 1:04 1:04 1:04
0:00 0:00 0:00 1:03 0:00 0:00 0:00 0:00 0:00 1:01 0:00 0:00 0:00 0:00 0:00 1:04
0:00 0:00 0:00 1:03 0:00 0:00 0:00 0:00 0:00 1:01 0:00 0:00 0:00 0:00 0:00 1:04
